INSERT	INS
INSERTION	INS
INSERTED	INS
INSERTING	INS
DUPLICATE	DUP
DUPLICATION	DUP
DUPLICATED	DUP
DUPLICATING	DUP
DELETE	DEL
DELETION	DEL
DELETED	DEL
DELETING	DEL
INSERTION/DELETION	INDEL
DELETION/INSERTION	INDEL
INSERTIONDELETION	INDEL
DELETIONINSERTION	INDEL
DELINS	INDEL
LACK	DEL
LACKED	DEL
LACKING	DEL
LOSE	DEL
LOSING	DEL
LOSED	DEL
COPY	DUP
REPEAT	DUP
REPEATED	DUP
DELTA	DEL
D	DEL
